R 1600 900
NO ./images/mur_N.xpm
SO ./images/mur_S.xpm
WE ./images/mur_W.xpm
EA ./images/mur_E.xpm
S ./images/mur_N.xpm
F 120,120,120
C 47,79,79

11111111111111111111111111111  111
1000000000110000000000100202111101
1011000001110000000000101222100001
100100000000000N000000101222111111
10110000011100000000000022221
10000000001100000111011112221
111101111111110111000000122211111
111101111111110111010100122211111
11000000110101011100000012221
10000000000000001100000012221
10000000000000001101010012221
11000000110101011111011112221
11110111111101011111011112221
11111111111111111111111112221
                        12221
          1111          12221
          1001          12221
          1111          12221
                        11111


         111111
         100001
         111111

